.;.;.;O;.;.;.
O;.;0X;.;X;O;.
.;X;.;.;O;2X;.
.;O;.;0X;.;.;O
.;X;O;.;.;1X;.
.;O;4X;O;X;O;.
.;.;O;.;.;.;.
hard;7;0;0;;;
