O;2X;.;O;1X;.;O
.;O;.;X;.;O;3X
1X;.;.;.;.;.;O
O;X;.;0X;.;X;.
.;.;O;.;.;.;0X
2X;O;.;X;O;.;.
O;.;X;O;.;1X;O
easy;7;0;0