O;3X;O;.;X;.;O
.;O;2X;.;.;O;X
X;.;.;0;.;3X;O
.;.;O;X;.;O;.
O;2X;.;.;O;.;X
X;O;.;.;1X;.;.
O;.;1X;O;.;1X;O
hard;7;0;0;;;
