O;.;.;.;.;1X;O
1X;.;.;O;.;.;.
.;.;O;4X;O;.;.
.;.;2X;O;3X;O;.
.;O;.;X;.;.;.
.;.;.;.;O;.;0X
O;2X;O;.;.;.;.
easy;7;0;0;;;
